111111
11E001
10P001
1C0C11
111111