111111
10E001
10P001
100C11
111111