11111111111111
10000000C11EC1
10000110110001
1CPC1000000001
11111111111111