1111111111111111111111111111
10001000C1000000010000C00001
1000111000100000P000000C1001
100010000C0000000000000010E1
1111111111111111111111111111