111111
1E0001
1CP101
1011C1
111111