11111111111
1P000C000E1
10110001101
1010C000101
1000010C001
100C1110C01
11111111111